# 来自图表的资源。性质
alreadyConnected=已连接的节点
cancel=取消
close=关闭
collapse-expand=折叠/扩展
containsValidationErrors=包含验证错误
done=完成
doubleClickOrientation=双击以更改方向
error=错误
errorSavingFile=保存文件时出错
ok=好啊
updatingDocument=更新文件。请稍候...
updatingSelection=更新所选内容。请稍候...
# 自定义资源
about=关于
actualSize=实际尺寸
add=添加
addLayer=添加图层
addProperty=添加属性
addToExistingDrawing=添加到现有图形
addWaypoint=添加航路点
advanced=高级
align=排列
alignment=对齐
allChangesLost=所有更改都将丢失!
angle=角
apply=申请
arc=弧
arrange=排列
arrow=单箭头
arrows=箭头
automatic=自动的
autosave=自动保存
autosize=自动调整大小
back=返回
background=背景
backgroundColor=背景色
backgroundImage=背景图片
basic=基本
block=块
blockquote=块引用
bold=加粗
border=边框
borderWidth=边框宽度
borderColor=边框颜色
bottom=底部
bottomAlign=底部对齐
bottomLeft=左下角
bottomRight=右下角
bulletedList=符号列表
cannotOpenFile=无法打开文件
center=居中
change=改变
changeOrientation=改变方向
circle=圆圈
classic=经典
clearDefaultStyle=清除默认样式
clearWaypoints=清除航路点
clipart=美工图案
collapse=折叠
collapseExpand=折叠/扩展
collapsible=可折叠
comic=连环画
connect=连接
connection=连接
connectionPoints=连接点
connectionArrows=连接箭头
constrainProportions=约束比例
copy=复制
copyConnect=连接时复制
copySize=拷贝大小
create=创建
curved=弯曲
custom=自定义尺寸
cut=切
dashed=虚线
decreaseIndent=减少缩进
default=默认
delete=删除
deleteColumn=删除列
deleteRow=删除行
diagram=图表
diamond=菱形
diamondThin=菱形(薄)
direction=方向
distribute=分配
divider=分隔器
documentProperties=文档属性
dotted=斑点
dpi=点每英寸
drawing=图纸{1}
drawingEmpty=绘图是空的
drawingTooLarge=这幅图太大了
duplicate=副本
duplicateIt=副本{1}
east=东
edit=编辑
editData=编辑数据
relationOrder=关联单据
editDiagram=编辑图表
editImage=编辑图片
editLink=编辑链接
editStyle=编辑样式
editTooltip=编辑工具提示
enterGroup=进入组
enterValue=输入值
enterName=输入名称
enterPropertyName=输入属性名
entityRelation=实体联系
exitGroup=退出组
expand=扩大
export=导出
extras=其他
file=文件
fileNotFound=找不到文件
filename=文件名
fill=填充
fillColor=填充颜色
fitPage=适合一页面
fitPageWidth=页宽
fitTwoPages=适合两页
fitWindow=适配窗口
flip=翻转
flipH=水平翻转
flipV=垂直翻转
font=字体
fontFamily=字体系列
fontColor=字体颜色
fontSize=字号
format=格式
formatPanel=格式面板
general=通用
formatPdf=PDF
formatPng=PNG
formatGif=GIF
formatJpg=JPEG
formatSvg=SVG
formatXml=XML
formatted=格式化
formattedText=格式化文本
gap=间隔
glass=玻璃
global=全局
gradient=渐变
gradientColor=渐变颜色
grid=网格
gridSize=网格大小
group=组
guides=导向
heading=标题
height=高
help=帮助
hide=隐藏
hideIt=隐藏 {1}
hidden=隐藏的
home=主页
horizontal=水平
horizontalFlow=水平流动
horizontalTree=水平树
html=HTML
id=ID
Flowchart=流程图
image=图片
images=图片
import=导入
increaseIndent=新增缩进
insert=插入
insertColumnBefore=向左插入列
insertColumnAfter=向右插入列
insertHorizontalRule=插入水平尺
insertImage=插入图片
insertLink=插入链接
insertRowBefore=在上面插入行
insertRowAfter=在下面插入行
invalidInput=无效输入
invalidName=无效名称
invalidOrMissingFile=无效或缺少文件
isometric=等距
italic=斜体
layers=层
landscape=横向
laneColor=车道颜色
layout=布局
left=左
leftAlign=左对齐
leftToRight=从左到右
line=线
link=链接
lineJumps=跳线
lineend=线端
lineheight=线高
linestart=线路起点
linewidth=线宽
loading=加载中
lockUnlock=锁定/解锁
manual=手册
middle=中间
misc=杂项
more=更多
moreResults=更多结果
move=移动
moveSelectionTo=将所选内容移动到 {1}
navigation=导航
new=新建
noColor=没有颜色
noFiles=没有文件
noMoreResults=没有更多的结果
none=没有
noResultsFor=没有结果'{1}'
normal=正常
north=北
numberedList=编号清单
opacity=透明度
open=打开
openArrow=开放式箭头
openFile=打开文件
openLink=打开连接
openSupported=支持的格式为。从该软件保存的XML文件
openInNewWindow=在新窗口中打开
openInThisWindow=在这个窗口打开
options=选项
organic=器质性
orthogonal=直角
outline=概述
oval=椭圆
pages=页
pageView=页面查看
pageScale=页面比例
pageSetup=页面设置
panTooltip=空格+拖动以滚动
paperSize=纸张尺寸
paste=粘贴
pasteHere=粘贴在这里
pasteSize=粘贴大小
pattern=模式
perimeter=周边
placeholders=占位符
plusTooltip=单击以连接和克隆（ctrl+单击以克隆，shift+单击以连接）。拖动以连接（按住ctrl键并拖动以克隆）
portrait=竖向
position=位置
posterPrint=图像打印
preview=预览
print=打印
radialTree=径向树
redo=重做
removeFormat=清除格式
removeFromGroup=从组中删除
removeIt=删除{1}
removeWaypoint=移除航路点
rename=重命名
renameIt=重命名 {1}
replace=代替
replaceIt={1} 已经存在。你想更换它吗?
replaceExistingDrawing=替换现有图形
reset=重置
resetView=重置视图
reverse=翻转
right=右
rightAlign=右对齐
rightToLeft=从右向左
rotate=旋转
rotateTooltip=单击并拖动以旋转，单击以仅将形状旋转90度
rotation=旋转tion{1}
sketch=素描
rounded=圆的
save=保存
saveAs=另存为
saved=保存的
scrollbars=滚动条
search=搜索
searchShapes=搜索形状
selectAll=全选
selectEdges=选择边
selectFont=选择一种字体
selectNone=选择无
selectVertices=选择顶点
setAsDefaultStyle=设置为默认样式
shadow=阴影
shape=形状
sharp=锋利的
sidebarTooltip=单击展开。将形状拖放到图表中。按住Shift键并单击以更改选择。Alt+单击以插入并连接
simple=简单
simpleArrow=简单箭头
size=大小
solid=固体
sourceSpacing=源间距
south=南
spacing=间距
straight=直
strikethrough=删除线
strokeColor=线条颜色
style=样式
subscript=下标
superscript=上标
table=表格
targetSpacing=目标间距
text=文字
textAlignment=文本对齐方式
textOpacity=文本不透明度
toBack=返回
toFront=到前面
tooltips=工具提示
top=顶部
topAlign=顶部对齐
topLeft=左上角
topRight=右上角
transparent=透明的
turn=仅将形状旋转90°
uml=UML
underline=下划线
undo=撤消
ungroup=取消分组
url=URL
untitledLayer=无标题图层
vertical=垂直
verticalFlow=垂直流动
verticalTree=垂直树
view=视图
waypoints=航点
west=西
width=宽度
wordWrap=自动换行
writingDirection=编写方向
zoom=缩放
zoomIn=放大
zoomOut=缩小

